width="100" height="100" tilewidth="32" tileheight="32"
1,1,1,1,1,1,1,1,1,1,1,1,1,1,1,1,1,1,1,1,1,1,1,1,1,1,1,1,1,1,1,1,1,1,1,1,1,1,1,1,1,1,1,1,1,1,1,1,1,1,1,1,1,1,1,1,1,1,1,1,1,1,1,1,1,1,1,1,1,1,1,1,1,1,1,1,1,1,1,1,1,1,1,1,1,1,1,1,1,1,1,1,1,1,1,1,1,1,1,1,
1,1,1,1,1,1,1,1,1,1,1,1,1,1,1,1,1,1,1,1,1,1,1,1,1,1,1,1,1,1,1,1,1,1,1,1,1,1,1,1,1,1,1,1,1,2,2,2,1,1,1,1,1,1,1,1,1,1,1,1,1,1,1,1,1,1,1,1,1,1,1,1,1,1,1,1,1,1,1,1,1,1,1,7,1,1,1,1,1,1,1,1,2,1,1,1,1,1,1,1,
1,1,1,1,1,1,1,1,1,1,1,1,1,1,1,1,1,1,1,1,1,1,1,1,1,1,1,1,1,1,1,1,1,1,1,1,1,1,1,1,1,1,1,1,2,1,1,1,1,1,2,2,1,1,2,2,2,2,1,1,1,1,1,1,1,1,1,1,1,1,1,1,1,1,1,1,1,1,1,1,1,1,1,1,1,1,1,1,1,1,1,1,1,1,1,1,1,1,1,1,
1,1,1,1,3,3,1,1,1,1,1,7,1,1,1,1,1,1,1,1,1,1,1,1,4,4,4,4,4,4,4,4,4,4,4,4,1,1,1,1,1,1,1,1,2,2,2,1,1,1,7,7,1,1,1,1,1,1,1,1,1,1,1,1,1,1,1,1,1,1,1,1,3,1,1,1,1,1,1,1,1,1,1,1,1,1,1,1,1,1,1,1,1,1,1,1,2,2,1,1,
1,1,1,1,3,4,1,1,1,1,7,7,1,1,1,1,1,1,1,1,1,1,1,4,4,4,4,4,4,4,4,4,4,4,4,4,4,4,1,1,1,1,1,1,1,1,1,1,1,1,1,1,1,1,1,1,1,1,1,1,1,1,1,1,1,1,1,1,1,1,3,3,3,1,1,1,1,1,1,1,1,1,1,1,1,1,1,1,1,1,1,1,7,7,7,1,1,2,1,1,
1,1,1,1,3,4,1,1,1,1,7,1,1,1,1,1,1,1,1,1,1,4,4,4,4,9,1,1,1,1,1,1,4,4,4,4,4,4,4,4,4,1,1,1,1,1,1,1,2,2,1,1,1,1,1,1,1,1,1,1,1,1,1,1,4,4,4,4,4,4,3,4,4,4,4,4,4,4,4,4,4,4,4,4,1,1,1,1,1,1,1,1,1,1,1,1,1,1,1,1,
1,1,1,1,3,4,1,1,1,1,7,1,1,1,1,1,1,1,1,1,4,4,4,5,1,1,1,1,1,1,1,1,1,1,1,4,4,4,4,4,4,4,4,1,1,1,1,1,1,1,1,1,1,1,1,1,1,1,1,1,4,4,4,4,4,4,4,4,3,3,3,3,9,1,1,1,1,1,1,1,1,1,1,1,4,4,4,4,1,1,1,1,1,1,1,1,1,1,1,1,
1,1,1,1,3,4,1,1,1,1,7,1,1,1,1,1,1,1,1,4,4,4,1,1,1,1,1,1,1,1,1,1,1,1,1,1,1,1,4,4,4,4,4,4,4,4,1,1,1,1,1,1,1,1,1,1,1,1,1,4,3,4,4,4,4,1,1,1,1,1,3,3,1,1,1,1,1,1,1,1,1,1,1,1,1,1,1,1,4,4,1,1,1,1,1,1,1,1,1,1,
1,1,1,1,3,4,1,1,1,1,1,1,1,1,1,1,1,1,4,4,4,1,1,1,1,7,1,1,1,1,1,1,7,7,1,1,1,1,1,1,4,4,4,4,4,4,4,4,1,1,1,1,1,1,1,1,1,4,4,3,4,4,1,1,1,1,1,1,1,1,3,3,1,1,1,1,1,1,1,1,1,1,1,1,1,1,1,1,1,1,4,1,1,1,1,1,1,1,1,1,
1,1,1,1,3,4,4,1,1,1,1,1,1,1,1,1,1,4,4,4,1,1,1,1,1,7,1,1,1,1,1,1,1,1,1,1,1,1,1,1,1,1,4,4,4,4,4,4,4,1,1,1,1,1,4,4,4,3,4,4,4,1,1,1,1,1,1,1,1,3,3,3,1,1,1,1,1,1,1,1,1,1,1,1,1,1,1,1,1,1,1,4,1,1,1,1,1,1,1,1,
1,1,1,1,5,3,4,1,1,1,1,1,1,1,1,1,4,4,4,5,1,1,1,1,7,7,2,2,2,1,1,1,1,1,1,1,1,1,1,1,1,1,1,1,4,4,4,4,4,4,4,4,4,4,4,4,4,4,4,1,1,1,1,1,1,1,1,1,3,3,3,3,1,1,1,1,2,2,2,2,1,1,1,1,1,1,1,1,1,1,1,5,4,1,1,1,1,1,1,1,
1,1,1,1,1,3,4,4,1,1,1,1,1,1,1,4,4,4,1,1,1,1,1,7,2,2,2,2,1,2,2,1,1,1,1,1,1,1,1,1,1,1,1,1,1,1,1,4,4,4,4,4,4,4,4,4,9,1,1,1,1,1,1,1,1,1,1,3,3,3,3,5,1,1,1,1,8,1,1,1,1,1,1,1,1,1,1,1,1,1,1,1,4,1,1,1,1,1,1,1,
1,1,1,1,1,1,4,4,4,1,1,1,1,1,4,4,4,1,1,1,1,1,7,7,2,1,2,1,1,1,1,1,1,1,1,1,1,1,1,1,1,1,1,1,1,1,1,1,1,1,1,1,1,1,1,1,1,1,1,1,1,1,1,1,1,1,3,3,3,1,1,1,1,1,1,1,1,1,1,1,1,1,1,1,1,1,1,1,1,1,1,1,4,1,1,1,1,1,1,1,
1,1,1,1,1,1,3,4,4,4,1,1,1,4,4,4,1,1,1,1,1,1,2,2,1,2,1,1,1,1,1,1,1,1,1,1,1,1,1,1,1,1,1,1,1,1,1,1,1,1,1,1,1,1,1,1,1,1,1,1,3,3,3,3,3,3,3,1,1,1,1,1,1,1,1,1,1,1,1,1,1,1,1,1,1,1,1,1,1,1,1,1,5,1,1,1,1,1,1,1,
1,1,1,1,1,1,1,3,3,4,4,1,4,4,4,9,1,1,1,1,1,1,2,2,1,2,1,1,1,2,2,2,2,2,1,1,1,1,1,1,1,1,1,1,1,1,1,1,1,1,1,1,1,1,1,3,3,3,3,3,3,3,3,3,3,3,1,1,1,1,1,1,1,1,1,1,1,7,7,1,1,1,1,1,1,1,1,1,1,1,1,1,1,1,1,1,1,1,1,1,
1,1,1,1,1,1,1,1,1,3,4,1,4,4,4,1,1,1,1,1,1,2,2,2,1,2,2,2,2,1,1,1,1,1,2,2,2,1,1,1,1,1,1,1,1,1,1,1,1,1,1,1,3,3,3,3,3,3,3,3,3,3,3,3,3,9,1,1,1,1,1,1,1,8,1,1,1,1,1,1,1,1,1,1,1,1,1,1,1,1,1,1,1,1,1,1,1,1,1,1,
1,1,1,1,1,1,1,1,1,3,4,4,4,9,1,1,1,1,1,1,1,2,2,1,2,1,2,1,1,1,1,1,1,1,1,1,2,2,1,7,1,1,1,1,1,1,1,3,3,3,3,3,3,3,3,1,1,1,1,1,1,1,1,1,1,1,1,1,1,1,1,1,1,1,1,1,1,1,1,1,1,1,1,1,1,1,1,1,1,1,1,1,1,1,1,2,1,1,1,1,
1,1,1,1,2,2,2,1,1,1,3,3,4,1,1,1,1,1,1,1,1,2,2,1,2,1,2,7,1,1,1,1,1,1,1,1,1,2,1,1,1,1,1,1,1,3,3,3,3,3,3,1,1,1,1,1,1,1,1,1,1,1,1,1,1,1,1,1,1,1,1,1,1,1,1,1,1,1,1,1,1,1,1,1,1,1,1,1,1,1,1,1,1,1,1,2,1,1,1,1,
1,1,1,2,2,1,2,1,1,1,1,3,4,1,1,1,1,1,1,1,1,2,2,1,2,1,2,2,2,2,2,2,2,2,2,2,2,1,1,1,1,1,1,1,3,3,3,3,3,1,1,1,1,1,1,1,1,1,1,1,1,1,1,1,1,1,1,2,1,1,1,1,1,1,2,2,2,2,2,1,1,1,1,1,1,1,1,1,1,1,1,7,7,1,1,2,1,1,1,1,
1,1,1,2,1,2,2,1,1,1,1,3,4,1,1,1,1,1,1,1,1,2,2,2,2,2,2,2,1,1,1,1,1,1,1,1,1,1,1,1,1,1,1,3,3,3,3,3,1,1,1,1,1,1,1,1,1,1,1,1,2,2,1,1,1,2,2,2,1,1,1,1,1,1,2,1,1,1,1,8,1,1,1,1,1,1,1,1,1,1,1,1,1,1,1,2,1,1,1,1,
1,1,2,2,1,2,1,1,1,1,1,3,4,1,1,1,1,1,1,1,1,2,2,2,2,2,2,2,1,1,1,1,1,1,1,1,1,1,1,1,1,1,1,3,3,3,1,1,1,1,1,1,1,1,1,1,1,1,1,2,2,1,1,1,1,1,1,1,1,1,1,1,1,1,2,1,1,1,1,1,1,1,1,3,3,3,1,1,1,1,1,1,1,1,1,2,1,1,1,1,
1,1,2,1,1,2,1,1,1,1,1,3,4,1,1,1,1,1,1,1,1,1,1,1,2,1,2,2,2,1,1,1,1,1,1,1,1,1,1,1,1,1,1,3,3,3,1,1,1,1,1,1,1,1,1,1,1,1,2,2,8,1,1,1,1,1,1,1,1,1,1,1,1,1,2,1,1,1,1,1,1,1,1,3,3,3,3,3,3,1,1,1,1,1,1,1,2,1,1,1,
2,1,1,1,1,1,1,1,1,1,1,3,4,1,1,1,1,1,1,1,1,1,2,2,1,1,1,1,2,1,1,1,1,1,1,1,1,1,1,1,1,1,1,3,3,3,3,3,1,1,1,1,1,1,1,1,1,1,1,1,8,1,1,1,1,1,1,1,1,1,1,1,1,1,2,1,1,1,1,1,1,1,1,1,3,3,2,3,3,3,1,1,1,1,1,1,2,2,1,1,
2,2,1,1,1,1,1,1,1,1,3,3,4,4,1,1,1,1,1,1,2,2,1,1,1,1,7,7,7,7,1,1,1,1,1,1,3,3,3,3,3,3,3,3,3,3,3,3,3,3,1,1,1,1,1,1,1,1,2,1,1,1,1,1,1,1,1,1,1,1,1,1,1,1,1,1,1,1,1,1,1,1,1,1,5,3,2,3,3,3,3,1,1,1,1,1,1,1,1,1,
1,1,1,2,1,1,1,1,1,1,3,4,4,4,1,1,1,1,1,2,1,1,1,1,1,1,1,1,1,1,1,1,1,1,3,3,3,9,1,1,1,1,1,3,1,3,3,3,3,3,3,1,1,1,1,1,1,1,2,1,1,1,1,1,1,1,1,8,1,2,1,1,1,1,1,1,1,1,1,1,1,1,1,1,1,3,3,2,3,3,3,3,1,1,1,1,1,1,1,1,
1,1,1,2,1,1,1,1,1,3,4,1,5,1,4,1,1,1,1,1,1,1,1,1,1,1,1,1,1,1,1,1,1,3,1,1,1,1,1,1,1,1,1,3,1,1,1,1,3,3,3,3,1,1,1,1,1,1,2,2,1,1,1,1,1,1,1,2,2,1,1,1,1,1,1,1,1,1,1,1,1,1,1,4,4,4,4,3,3,3,3,3,3,1,1,1,1,1,1,1,
1,1,1,1,1,1,1,1,3,4,4,1,1,1,1,4,1,1,1,1,1,1,1,1,1,1,1,1,1,1,1,3,3,1,1,1,1,1,1,1,1,1,1,3,1,1,1,1,1,3,3,3,3,3,1,1,1,1,1,1,1,1,2,2,1,1,1,1,1,1,1,1,1,1,1,1,1,1,1,1,4,4,4,1,1,1,1,4,1,3,3,3,3,1,1,1,1,1,1,2,
1,1,1,1,1,1,1,3,4,4,1,1,1,1,1,1,4,1,1,1,1,1,1,1,1,1,1,1,1,1,3,3,1,1,1,1,1,1,1,1,1,1,1,3,1,1,1,1,1,1,1,3,3,3,3,3,1,1,1,1,1,1,1,1,1,1,1,1,1,1,1,1,1,1,1,1,1,4,4,4,1,1,1,1,1,1,1,5,1,1,3,3,3,3,1,1,1,1,1,2,
1,1,1,1,1,1,3,4,4,1,1,1,1,1,1,1,1,4,1,1,1,1,1,1,1,1,1,1,1,3,1,1,1,1,1,1,1,1,1,1,1,1,1,3,1,1,1,1,1,1,1,1,1,3,3,3,3,3,3,1,1,1,1,1,1,1,1,1,1,1,1,1,1,4,4,4,4,1,1,1,1,1,1,1,1,1,1,1,1,1,1,3,3,3,1,1,1,1,1,2,
1,1,1,1,1,3,4,4,1,1,1,1,1,1,1,1,1,1,4,4,1,1,1,1,1,1,1,3,3,1,1,1,1,1,1,7,1,1,1,1,1,1,1,3,1,1,1,1,1,1,1,1,1,1,1,3,3,3,3,3,3,1,1,1,1,1,1,1,1,1,1,1,4,1,1,1,1,1,1,1,1,1,1,1,1,1,1,1,1,1,1,1,3,3,1,1,1,1,1,1,
1,1,1,1,3,4,4,1,1,1,1,1,1,1,1,1,1,1,1,1,4,1,1,1,1,1,3,9,1,1,1,1,1,1,1,1,1,1,1,1,1,1,1,3,1,1,1,1,1,1,1,1,1,1,1,1,1,3,3,3,3,3,1,1,1,1,1,1,4,4,4,4,1,1,1,1,1,1,1,1,1,1,1,1,1,1,1,1,1,1,1,1,3,3,1,1,1,1,1,1,
1,1,1,3,1,4,1,1,1,1,2,1,1,1,1,1,1,1,1,1,1,4,4,3,3,3,1,1,1,1,8,1,1,1,1,1,1,1,1,1,1,1,1,3,1,1,1,1,1,1,1,1,1,1,1,1,1,1,1,3,3,3,1,1,1,1,1,4,1,1,1,1,1,1,1,1,1,1,1,1,1,1,1,1,1,1,1,1,1,1,1,1,3,3,1,1,1,1,1,1,
1,1,3,1,4,4,4,1,1,2,2,2,2,2,2,1,1,1,1,1,1,1,3,3,4,3,3,1,1,1,1,1,1,1,1,1,1,7,7,1,1,1,1,3,1,1,1,1,1,1,1,1,1,1,1,1,1,1,1,3,3,3,1,1,1,1,4,1,1,1,1,1,1,1,1,1,1,1,1,1,1,1,1,1,1,1,1,1,1,1,1,1,3,3,1,1,1,1,2,2,
1,3,1,1,1,1,4,1,2,2,2,1,1,1,1,1,1,1,1,1,1,1,3,3,2,4,3,3,1,1,1,1,1,1,1,1,1,1,7,1,1,1,1,3,1,1,1,1,1,1,2,2,1,1,1,1,1,1,1,1,3,3,1,1,4,4,1,1,1,1,1,1,1,1,1,1,1,1,7,7,1,1,1,1,2,2,1,1,1,1,1,1,3,3,1,1,1,1,2,1,
3,5,1,1,1,1,5,2,2,2,1,1,1,1,1,1,1,1,1,1,1,1,3,2,2,2,2,3,3,3,4,1,1,1,1,1,1,1,1,1,1,1,1,1,3,1,1,1,1,2,2,1,1,1,1,1,1,1,1,1,3,3,4,4,1,1,1,1,1,1,1,1,1,1,1,1,7,1,1,1,1,1,7,1,1,1,1,1,1,1,1,1,3,3,1,1,1,1,2,1,
3,1,1,1,1,1,1,2,2,1,1,1,1,1,1,1,1,1,1,1,1,1,3,2,2,3,3,3,3,3,3,3,4,4,1,1,1,1,1,1,1,1,1,1,3,1,1,1,1,2,1,1,1,1,1,1,1,1,1,1,3,4,1,1,1,1,1,2,2,1,1,1,1,1,1,7,1,1,1,1,1,1,7,2,2,2,1,1,1,1,1,1,3,3,1,1,1,1,2,1,
1,1,1,1,1,2,2,2,1,1,1,1,1,1,1,1,1,1,1,1,1,1,3,3,3,1,1,1,1,1,3,3,3,3,4,1,1,1,1,1,1,1,1,1,3,1,1,1,1,2,1,1,1,1,1,1,1,1,4,4,3,1,1,1,1,1,1,1,1,1,1,7,1,1,1,1,1,1,1,1,1,1,7,1,1,1,2,1,1,1,1,1,3,3,1,1,1,1,2,1,
1,1,1,1,1,2,1,2,1,1,1,1,1,1,1,1,1,1,1,1,3,3,3,1,1,1,1,1,1,1,1,1,1,3,3,3,4,4,1,1,1,1,1,1,1,1,1,1,2,1,1,1,1,1,1,1,4,4,1,1,3,1,1,1,1,1,1,1,1,1,1,1,1,1,1,1,1,1,1,1,1,1,1,1,1,1,1,1,1,1,1,1,3,3,1,1,1,1,1,1,
1,1,1,1,2,1,1,1,2,1,1,1,1,1,1,1,1,1,3,3,1,3,1,1,1,1,1,1,1,1,1,1,1,1,1,3,3,3,4,4,1,1,7,1,1,1,1,1,2,1,1,1,1,1,1,4,1,1,1,1,3,1,1,1,1,1,1,1,8,1,1,1,1,1,1,1,1,1,1,1,1,1,1,1,1,1,1,1,1,1,1,4,3,3,1,1,1,1,1,1,
1,1,1,1,2,1,1,1,2,1,1,1,1,1,1,1,3,3,1,1,1,3,1,1,1,1,1,1,1,1,1,1,1,1,1,1,1,3,3,4,1,1,1,1,1,1,1,2,2,1,1,1,1,4,4,1,1,1,1,3,3,1,1,1,1,1,1,8,1,1,1,1,1,1,1,1,2,2,7,1,1,1,1,1,1,1,1,1,1,1,1,4,4,3,1,1,1,1,1,1,
1,1,1,1,2,1,7,1,2,1,1,1,1,1,1,3,1,1,1,1,3,1,1,1,1,1,1,1,1,1,1,1,1,1,1,1,1,1,3,4,1,1,1,1,1,1,2,2,1,1,1,1,4,1,1,1,1,1,3,3,3,1,1,1,1,1,1,8,8,1,1,1,1,1,1,1,1,1,1,2,2,1,1,1,1,1,1,1,1,1,1,4,4,3,1,1,1,1,1,1,
1,1,1,1,2,1,1,1,1,1,1,1,1,1,3,1,1,1,1,1,3,1,1,1,7,1,1,1,1,1,1,1,1,1,1,1,1,1,3,4,1,1,1,1,2,2,2,1,1,1,4,4,1,1,1,1,1,3,3,3,3,4,4,1,1,1,1,1,1,8,1,1,1,1,1,1,1,1,1,1,2,1,1,1,1,1,1,1,1,1,1,4,4,3,1,1,1,1,1,1,
1,1,1,1,2,1,1,1,1,1,1,1,1,1,3,1,1,1,1,3,1,1,1,1,1,1,2,2,2,1,1,1,1,1,1,1,1,1,3,4,1,1,2,2,2,1,1,1,1,4,1,1,1,1,1,1,1,3,3,3,1,1,1,4,4,1,1,1,1,1,1,1,1,1,8,8,1,1,1,1,1,2,2,1,1,1,1,1,1,1,1,4,4,3,1,1,1,1,1,1,
1,1,1,1,2,1,1,1,1,1,1,1,1,1,3,1,1,1,1,3,1,1,1,1,1,1,1,1,1,1,1,1,1,1,1,1,1,1,3,4,1,1,1,1,1,1,1,4,4,1,1,1,1,1,1,1,3,3,3,1,1,1,1,1,1,4,1,1,1,1,1,1,1,1,1,8,8,1,1,1,1,1,1,1,1,1,1,1,1,1,1,4,4,3,1,1,1,1,2,1,
1,1,1,1,2,2,1,2,1,1,1,1,1,1,3,1,1,1,3,1,1,1,1,1,1,1,1,1,8,1,1,1,1,1,1,1,1,1,3,4,1,1,1,1,1,1,4,1,1,1,1,1,1,1,1,3,3,3,1,1,1,1,1,1,1,1,4,1,1,1,1,1,1,1,1,1,8,1,1,1,1,1,1,1,1,1,1,2,1,1,1,4,4,3,1,1,1,1,2,1,
1,1,1,1,1,2,2,2,1,1,1,1,1,1,3,1,1,1,3,1,1,1,1,1,1,1,1,1,1,1,1,1,1,1,1,1,1,1,3,4,1,1,1,1,1,4,1,1,1,1,1,7,1,1,1,3,3,3,1,1,1,1,1,1,1,1,1,4,4,1,1,1,1,1,1,1,1,1,1,1,1,1,1,1,7,1,1,2,1,1,1,4,4,3,1,1,1,1,2,1,
1,1,1,1,1,1,2,2,1,1,1,1,1,1,3,1,1,3,1,1,1,1,1,1,1,1,1,1,1,1,1,2,1,1,1,1,1,1,3,4,1,1,1,1,4,1,1,1,1,1,1,1,1,1,3,3,3,3,1,1,1,1,1,1,1,1,1,1,1,4,4,1,1,1,2,2,1,1,1,1,1,1,1,1,1,1,1,1,1,1,1,4,4,3,1,1,1,1,2,1,
1,1,1,1,1,1,1,2,2,1,1,1,1,1,3,1,3,1,1,1,1,1,1,1,1,1,1,1,1,1,1,1,2,1,1,1,1,1,3,4,1,1,1,4,1,1,1,7,1,1,1,1,1,3,3,3,3,1,1,1,1,1,2,1,1,1,1,1,1,1,1,4,1,1,1,2,1,1,1,1,1,1,1,1,1,1,1,1,1,1,1,4,4,3,1,1,1,1,2,1,
3,1,1,1,1,1,1,1,1,1,1,1,1,1,3,1,3,1,1,1,7,1,1,2,1,1,1,1,1,1,1,1,2,1,1,1,1,1,3,4,1,1,4,1,1,1,1,1,1,1,1,1,3,3,3,3,1,1,1,1,1,1,2,2,2,1,1,1,1,1,1,1,4,1,1,2,1,1,1,1,1,1,1,1,1,1,1,1,1,1,1,4,4,3,1,1,1,1,2,1,
3,1,1,1,1,1,1,1,1,1,1,1,1,1,3,3,9,1,1,1,1,1,1,2,1,1,1,1,1,1,7,2,1,1,1,1,1,1,3,4,1,4,1,1,1,1,1,1,1,1,1,1,3,3,3,1,1,1,1,1,1,1,1,1,2,1,1,1,1,1,1,1,4,1,1,1,2,1,1,1,1,1,1,1,1,1,1,1,1,1,1,4,4,3,1,1,1,1,2,1,
1,3,1,1,1,1,1,1,1,1,1,1,1,1,3,4,1,1,1,1,1,1,1,1,1,1,1,1,1,2,2,1,1,1,1,1,1,1,3,4,3,3,3,1,1,1,1,1,1,1,1,3,3,3,1,1,1,1,1,1,1,1,1,1,2,1,1,1,1,1,1,1,1,4,1,1,2,1,1,1,1,1,1,1,1,1,1,1,1,1,1,4,3,5,1,1,1,1,1,2,
1,5,3,3,1,1,1,1,1,1,1,1,1,1,3,4,4,1,1,1,1,1,1,1,1,1,1,1,2,2,1,1,1,1,1,1,1,1,3,4,3,3,3,3,3,3,3,3,1,1,3,3,3,3,1,1,1,1,1,1,1,7,1,1,2,2,1,1,1,1,1,1,1,1,4,1,2,1,1,1,1,1,1,1,1,1,1,1,1,1,1,4,3,1,1,1,1,1,1,2,
1,1,1,1,3,3,1,1,1,1,1,1,1,1,3,3,4,1,1,1,1,1,1,1,7,2,1,1,1,1,1,1,1,1,1,1,1,1,3,3,3,3,3,3,3,3,3,3,3,3,3,3,3,3,1,1,1,1,1,1,1,1,1,1,1,2,1,1,1,1,1,1,1,1,4,1,1,2,2,1,1,1,1,1,1,1,1,1,1,1,1,4,3,1,1,1,1,1,1,1,
1,1,1,1,1,1,3,3,1,1,1,1,1,3,1,3,4,1,1,1,1,1,1,1,2,1,1,1,1,1,1,1,1,1,1,1,1,1,4,3,3,4,3,3,3,3,3,3,3,3,3,3,3,3,3,1,1,1,1,1,1,1,1,1,1,2,2,1,1,1,1,1,1,1,4,1,1,1,1,2,1,1,1,1,1,1,1,2,1,1,4,4,3,1,1,1,1,1,1,1,
1,1,1,1,1,1,1,1,1,1,1,1,3,1,1,3,4,4,1,1,1,1,1,1,1,1,1,1,1,1,1,1,1,1,1,1,1,1,4,3,3,3,1,1,1,1,1,1,1,1,3,3,3,3,3,1,1,1,1,1,1,1,1,1,1,1,2,2,2,1,1,1,1,1,1,4,1,1,1,2,1,1,1,1,1,1,1,2,1,1,4,4,3,1,1,1,1,1,1,2,
1,1,1,1,1,1,1,1,1,1,1,3,1,1,1,1,3,4,1,1,1,1,1,1,1,1,1,1,1,1,1,1,1,8,1,1,1,1,4,3,3,3,1,1,1,1,1,1,1,1,1,3,3,3,3,3,1,1,1,1,1,1,1,1,1,1,1,1,1,2,2,1,1,1,1,1,4,1,1,1,2,1,1,1,1,1,1,2,1,1,4,4,3,1,1,1,1,1,1,2,
1,1,1,1,1,1,1,1,1,1,1,3,1,1,1,1,3,4,4,4,4,1,1,1,1,1,1,1,1,1,1,1,1,1,1,1,1,4,3,3,3,1,1,1,1,1,1,1,1,1,1,1,3,3,3,3,3,3,3,1,1,1,1,1,1,7,1,1,1,1,1,2,1,1,1,1,4,1,1,1,1,2,1,1,1,1,1,1,1,1,4,4,3,1,1,1,1,1,1,1,
1,1,1,1,1,1,1,1,1,1,3,1,1,1,1,1,1,3,3,3,4,4,4,4,4,4,4,1,1,1,1,1,1,1,1,1,1,3,3,3,1,1,1,1,1,1,1,7,1,1,1,1,1,1,1,3,3,3,3,3,3,1,1,1,1,1,1,1,1,1,1,2,1,1,1,1,1,4,1,1,1,2,1,1,1,1,1,1,1,1,4,3,5,1,1,1,1,1,1,1,
1,1,1,1,1,1,1,1,1,1,3,1,1,1,1,1,1,1,1,1,3,3,3,3,3,3,4,4,4,4,4,1,1,1,1,1,1,3,3,3,1,1,1,1,1,1,1,1,1,1,1,1,1,1,1,1,1,3,3,3,3,3,3,1,1,1,1,1,1,1,1,1,1,1,1,1,1,4,1,1,1,1,2,1,1,1,1,1,1,1,4,3,1,1,1,8,8,1,1,1,
1,1,1,2,1,1,1,1,1,1,3,1,1,1,1,1,1,1,1,1,1,1,1,1,1,1,3,3,3,3,4,4,4,4,4,4,4,3,3,3,1,1,1,1,1,1,1,1,1,1,1,1,1,1,1,1,1,1,1,3,3,3,3,3,1,1,1,1,1,1,1,1,1,1,1,1,1,1,4,1,1,1,2,1,1,1,1,1,1,4,4,3,1,1,1,1,1,1,1,1,
1,1,1,2,1,1,1,1,1,1,3,1,1,1,1,1,1,1,1,1,1,1,1,1,1,1,1,1,1,1,1,3,3,3,3,3,4,3,3,3,3,1,1,1,1,1,1,1,1,1,1,1,1,1,1,1,1,1,1,1,1,3,3,3,3,1,1,1,1,1,1,1,1,1,1,1,1,1,4,1,1,1,2,2,1,1,1,1,1,4,4,3,1,1,1,1,1,1,1,1,
1,1,1,2,1,1,1,1,1,1,3,1,1,1,1,1,1,1,1,1,1,1,1,1,1,1,1,1,1,1,1,1,1,1,1,4,1,1,1,1,1,3,3,3,1,1,1,1,1,1,1,1,1,1,1,1,7,1,1,1,1,1,1,3,3,3,3,3,3,1,1,1,1,1,1,1,1,1,4,1,1,1,1,2,1,1,1,1,1,4,4,5,1,1,1,1,1,1,1,1,
1,1,1,2,1,2,1,1,1,1,3,3,1,1,1,1,1,1,1,1,1,1,1,1,1,1,1,1,1,1,1,1,1,1,1,4,1,1,1,1,1,1,1,1,3,3,3,3,1,1,1,1,1,1,1,1,1,1,1,1,1,1,1,1,1,3,3,3,3,3,3,1,1,1,1,1,1,1,4,1,1,1,1,2,1,1,1,1,4,4,4,1,1,1,1,1,1,8,1,1,
1,1,1,2,1,2,1,1,1,1,1,3,1,1,1,1,1,1,1,1,1,1,1,1,1,1,1,1,1,1,1,1,1,1,4,1,1,1,1,1,1,1,1,1,1,1,1,1,3,3,3,1,1,1,1,1,1,1,1,1,1,1,1,1,1,1,1,3,3,3,3,3,3,1,1,1,1,1,4,1,1,1,1,2,1,1,1,1,4,4,3,1,1,1,1,1,1,8,1,1,
1,1,1,1,1,2,1,1,1,1,1,3,1,1,1,1,1,1,8,1,1,1,1,1,1,1,1,8,1,1,1,1,1,1,4,1,1,1,1,1,1,1,1,1,1,1,1,1,1,1,1,3,3,1,1,1,1,1,1,1,1,1,1,1,1,1,1,1,1,1,3,3,3,3,1,1,1,1,4,1,1,1,1,1,1,1,1,1,4,4,3,1,1,1,1,1,1,8,2,1,
1,1,1,1,1,2,1,1,1,1,1,3,1,1,1,1,1,1,1,1,1,1,1,1,1,1,1,1,1,1,1,1,1,1,4,1,1,1,1,1,1,1,1,1,1,1,1,1,1,1,1,1,1,3,3,3,1,1,1,1,1,1,1,1,1,1,1,1,1,1,6,3,3,3,1,1,1,1,4,1,1,1,1,1,1,1,1,1,4,4,3,1,1,1,1,1,1,1,1,1,
1,1,1,1,1,2,2,1,1,1,1,1,3,1,1,1,1,1,1,1,1,1,1,1,1,1,1,1,1,1,1,1,1,4,9,1,1,1,1,1,1,1,1,1,1,1,1,1,1,1,1,1,1,1,1,1,3,3,1,1,1,1,1,1,1,1,1,1,1,1,1,3,3,3,1,1,1,1,4,1,1,1,1,1,1,1,1,1,5,3,1,1,1,1,1,1,1,1,1,1,
1,1,1,1,1,1,2,1,1,1,1,1,3,1,1,1,1,1,1,1,1,1,1,1,1,1,1,1,1,1,1,1,1,4,1,1,1,1,1,1,1,1,1,1,1,1,1,1,1,1,1,1,1,1,1,1,1,1,3,3,1,1,1,1,1,1,1,1,1,1,1,5,3,3,1,1,1,1,4,1,1,1,1,1,1,1,1,3,3,3,1,1,1,1,1,1,1,1,1,1,
1,1,1,1,1,1,2,1,1,1,1,1,1,3,1,1,1,1,1,1,2,2,2,1,1,1,1,1,1,1,1,1,1,4,1,1,1,1,1,1,1,1,1,2,2,2,2,2,2,1,1,1,1,1,1,1,1,1,1,5,3,3,1,1,1,1,1,1,1,1,1,1,3,3,1,1,1,1,4,1,1,1,1,1,1,1,1,3,3,3,1,1,1,8,8,1,1,1,1,1,
1,1,1,1,1,1,1,1,1,1,1,1,1,3,1,1,1,1,1,1,1,1,1,1,8,1,2,1,1,1,1,1,1,2,1,1,1,1,1,1,1,1,1,2,1,1,7,1,2,2,2,1,1,1,1,1,1,1,1,1,1,1,3,3,3,1,1,1,1,1,1,1,3,3,1,1,1,1,4,1,1,1,1,1,1,1,1,3,3,3,1,1,8,8,1,1,1,1,1,1,
1,1,1,1,2,1,1,1,1,1,1,1,1,1,3,1,1,1,1,1,1,1,1,1,1,1,2,1,1,1,1,1,1,1,4,1,1,1,1,1,1,1,1,1,1,1,1,1,1,1,2,2,1,1,1,1,1,1,1,1,1,1,1,1,9,3,3,1,1,1,1,1,3,3,1,1,1,1,4,1,1,1,1,1,1,1,1,3,3,5,1,1,1,1,1,1,1,1,1,1,
1,1,1,1,2,1,7,1,1,1,1,1,1,1,3,3,1,1,1,1,1,1,1,1,1,1,2,2,2,1,1,1,1,1,4,1,1,1,1,1,1,1,1,1,1,1,1,1,1,1,1,1,2,2,2,2,2,2,2,1,1,1,1,1,1,1,1,3,3,1,1,1,5,3,3,1,1,1,4,1,1,1,1,1,1,1,3,3,3,1,1,1,1,1,1,1,1,1,1,1,
1,1,1,1,1,2,2,1,1,1,1,1,1,1,1,1,3,1,1,1,1,1,1,1,1,1,1,1,1,1,1,1,1,1,1,4,1,1,1,1,1,1,1,1,1,1,1,1,1,1,1,1,1,1,1,1,1,1,1,2,2,1,1,1,1,1,1,1,1,3,3,1,1,3,3,3,1,4,5,1,1,1,1,1,2,1,3,3,3,1,1,1,1,1,1,1,1,1,1,1,
1,1,1,1,1,2,2,2,1,1,1,1,1,1,1,1,1,3,3,3,3,3,1,1,1,1,1,1,1,1,1,1,1,1,1,1,4,1,1,1,1,1,1,1,1,1,1,1,1,1,1,1,1,1,1,1,1,1,1,1,1,2,1,1,1,1,1,1,1,1,5,3,3,1,3,3,1,4,1,1,1,1,1,1,1,1,3,3,1,1,1,1,1,1,1,2,1,1,1,1,
1,1,1,1,1,1,1,2,1,1,1,1,1,1,1,1,1,1,1,1,1,1,3,3,3,3,1,1,1,1,1,1,1,1,1,1,4,1,1,1,1,1,1,1,1,1,1,1,1,1,1,1,1,1,1,1,1,1,1,1,1,1,2,2,1,1,1,1,1,1,1,1,1,3,3,3,4,1,1,1,1,1,1,1,1,1,3,3,1,1,1,1,1,1,2,2,1,3,1,1,
1,1,1,1,1,1,1,1,1,1,1,1,1,1,1,1,1,1,1,1,1,1,1,1,1,1,3,3,3,3,1,1,1,1,1,1,4,1,1,1,1,1,1,7,1,1,1,1,1,1,1,1,1,7,1,1,1,1,1,1,1,1,1,2,1,1,1,1,1,1,1,1,1,1,3,3,4,1,1,1,1,1,1,1,1,1,3,3,1,1,1,1,1,1,2,1,1,3,1,1,
1,1,1,1,1,1,1,1,1,1,1,1,1,1,1,1,1,1,1,1,1,1,1,1,1,1,1,1,1,1,3,3,1,1,1,4,1,1,1,1,1,1,1,1,1,1,1,1,1,1,1,1,1,1,1,1,1,1,1,1,1,1,1,1,2,1,1,1,1,1,1,1,1,1,1,3,3,1,1,1,1,1,1,1,1,3,3,3,1,1,1,1,1,1,2,1,1,3,1,1,
1,1,1,1,1,2,1,2,2,1,1,1,1,1,1,1,1,1,1,1,1,1,1,1,1,1,1,1,1,1,1,1,3,1,1,4,1,1,1,1,1,1,1,1,1,1,1,1,1,1,1,1,1,1,1,1,1,1,1,1,1,1,1,1,2,2,1,1,1,1,1,1,1,1,1,4,3,3,1,1,1,1,1,1,1,3,3,1,1,1,1,1,8,1,1,1,1,3,3,1,
1,1,1,7,2,2,1,1,2,1,1,1,1,1,1,1,1,1,1,1,1,1,1,1,1,1,1,1,1,1,1,1,1,3,3,4,1,1,1,1,1,1,1,1,1,1,1,1,1,1,1,1,1,1,1,1,1,1,1,1,1,1,1,1,1,2,1,1,1,1,1,1,1,4,4,1,3,5,3,1,1,1,1,1,1,3,3,1,1,1,1,1,8,1,1,1,3,3,1,1,
1,1,1,7,2,1,1,1,1,1,1,1,1,1,1,1,1,1,1,1,1,1,1,1,1,1,1,1,1,1,1,1,1,1,1,3,3,3,1,1,1,1,1,1,1,7,1,1,1,1,1,1,1,1,1,1,1,1,1,1,1,1,1,1,1,2,1,1,1,1,1,1,4,5,1,1,3,1,1,3,1,1,1,1,1,3,3,1,1,1,1,1,8,1,1,1,3,3,1,1,
1,1,1,1,1,2,1,1,1,1,1,1,1,1,1,1,1,1,1,1,1,1,1,1,1,1,1,1,1,1,1,1,1,1,1,1,1,1,3,3,1,1,1,1,1,1,1,1,1,1,1,1,1,1,1,1,1,1,1,1,1,1,1,1,1,2,1,1,1,1,1,1,4,1,1,1,1,3,1,1,3,1,1,1,3,3,3,1,1,1,1,1,8,1,1,1,3,3,1,1,
1,1,1,1,1,2,1,1,1,1,1,1,1,1,8,3,3,3,3,1,1,1,1,1,1,1,1,1,1,1,1,1,1,1,1,1,1,1,1,1,3,3,1,1,1,1,1,1,1,1,1,1,1,1,1,1,1,1,1,1,1,1,1,1,1,2,1,1,1,1,1,4,1,1,1,1,1,1,1,1,1,3,1,1,3,3,3,1,1,1,2,1,1,1,1,1,3,3,1,1,
1,1,1,1,1,2,2,2,1,1,1,1,1,2,2,3,3,3,3,3,3,1,1,1,1,1,1,1,1,2,1,1,1,1,1,1,1,1,1,1,1,1,3,3,3,1,1,1,1,1,1,1,1,1,1,1,1,1,1,1,1,1,1,1,2,1,1,1,1,1,4,1,1,1,1,1,1,1,1,1,1,1,3,1,3,3,5,1,1,1,1,1,1,1,1,1,3,3,3,1,
1,1,1,1,1,1,1,1,1,1,1,1,1,2,2,1,10,3,3,3,2,3,1,1,1,1,1,1,1,2,2,1,1,1,1,7,1,1,1,1,1,1,1,1,1,3,3,3,1,1,1,1,1,1,1,1,1,1,7,1,1,1,1,1,2,1,1,1,1,4,1,1,1,1,1,1,1,1,1,1,1,1,1,3,3,3,1,1,1,1,1,8,1,1,1,1,1,3,3,1,
1,1,1,1,1,1,1,1,1,1,1,1,1,1,2,2,2,2,1,3,3,2,1,1,1,1,1,1,1,1,2,1,1,1,1,1,1,1,1,1,1,1,1,1,1,1,1,1,3,3,1,1,1,1,1,1,1,1,1,1,1,1,1,1,1,1,1,1,4,1,1,1,1,1,1,1,1,1,1,1,1,1,1,1,3,3,1,1,1,1,1,8,1,1,1,1,1,3,3,1,
1,1,1,1,1,1,1,1,1,1,1,1,1,1,1,1,1,2,2,5,3,3,2,2,2,1,1,1,1,1,1,1,1,1,1,1,1,1,1,1,1,1,1,1,1,1,1,1,1,1,3,1,1,1,1,1,1,1,1,1,1,1,1,1,1,1,1,4,1,1,1,1,1,1,1,1,1,1,1,1,1,1,1,1,3,3,1,1,1,1,1,1,1,1,1,1,1,3,3,1,
1,1,1,1,1,1,1,1,1,1,1,1,1,1,7,1,1,1,2,2,3,3,1,1,1,2,2,1,1,1,1,1,1,1,1,1,1,1,2,1,1,1,1,1,1,1,1,1,1,1,1,3,3,1,1,1,1,1,1,1,1,1,1,1,1,4,4,1,1,1,1,1,1,1,1,1,1,2,1,1,1,1,1,8,3,1,3,1,1,1,1,8,1,1,1,1,1,3,3,1,
1,1,1,1,1,1,1,1,1,1,1,1,1,1,1,1,1,1,1,2,3,3,3,1,1,1,1,1,1,1,1,1,1,1,1,1,1,1,2,2,2,1,1,1,1,1,1,1,1,1,1,1,1,3,3,1,1,1,1,1,1,1,1,1,4,9,1,1,1,1,1,1,1,1,1,2,1,1,1,1,1,1,1,3,1,1,3,1,1,1,1,8,1,1,1,1,1,3,3,1,
1,1,1,1,1,1,1,1,1,1,1,1,1,1,1,1,1,1,1,2,3,3,3,3,1,1,1,1,1,1,1,1,1,1,1,1,1,1,1,1,1,2,2,1,1,1,1,1,1,1,1,1,1,1,1,3,3,1,1,1,1,1,1,4,1,1,1,1,1,1,1,1,1,1,1,1,1,1,1,1,1,1,1,3,1,1,1,3,1,1,1,1,1,1,1,1,3,3,1,1,
1,1,1,1,1,1,1,2,2,2,2,2,2,1,1,1,1,1,1,1,1,3,3,3,1,1,1,1,1,1,1,1,1,1,1,1,1,1,1,1,1,1,2,2,1,1,1,1,1,1,1,1,1,1,1,1,1,3,3,1,1,4,4,1,1,1,1,1,1,1,1,1,1,1,1,1,1,1,1,1,1,1,1,3,1,1,1,3,3,1,1,1,1,1,1,1,3,3,1,1,
1,1,1,1,1,2,2,2,1,3,3,3,3,2,2,1,8,1,1,1,1,1,3,3,1,1,1,1,1,1,1,1,1,1,1,1,1,1,1,1,1,1,1,1,1,1,1,8,1,1,1,1,1,1,1,1,1,1,1,3,3,3,1,1,1,1,1,1,1,1,1,1,1,1,1,1,1,1,1,1,1,1,1,3,1,1,1,1,1,3,1,1,1,1,1,1,3,3,1,1,
1,4,4,4,2,2,1,1,1,3,1,5,3,3,3,2,2,1,1,1,1,1,3,3,1,1,1,1,1,1,1,1,1,2,1,1,1,1,1,1,1,1,1,1,1,1,1,1,1,1,1,1,1,1,1,1,1,4,4,3,3,3,3,3,1,1,1,1,1,1,1,1,1,1,1,1,1,1,1,1,1,1,1,3,1,1,1,1,1,3,1,1,1,1,1,1,3,3,1,1,
1,4,1,4,2,3,3,3,8,3,1,1,1,1,3,3,2,2,1,1,1,3,3,3,1,1,1,1,1,1,1,1,1,1,1,1,1,1,1,1,1,1,1,1,1,1,1,1,1,1,1,1,1,1,1,1,4,3,3,3,1,1,3,3,3,3,3,1,1,1,1,1,1,1,3,1,1,1,1,1,1,1,1,3,1,1,1,1,1,1,3,1,1,1,1,1,3,3,1,1,
1,1,1,4,2,2,3,3,3,3,1,1,1,1,1,3,3,2,1,1,3,3,3,3,1,1,1,1,1,1,1,1,1,1,1,8,1,1,1,1,1,1,1,1,1,2,1,1,1,1,1,1,1,1,4,4,3,3,1,1,1,1,1,1,1,3,3,3,3,1,1,1,1,1,3,3,3,1,1,1,1,1,1,3,1,1,1,1,1,1,1,1,1,1,1,1,3,3,1,1,
1,3,3,3,3,3,3,1,1,1,5,1,1,1,1,1,3,2,2,1,3,3,3,9,1,1,1,1,1,1,1,1,1,2,1,1,1,1,1,1,1,1,1,1,1,2,1,1,1,1,1,1,4,4,3,3,3,1,1,1,1,1,1,1,1,1,1,3,3,3,3,1,1,3,3,3,3,9,1,1,1,1,1,2,2,2,2,1,1,1,1,1,1,1,1,3,3,1,1,1,
1,3,4,4,3,3,3,1,2,2,2,2,1,1,1,1,3,3,2,1,1,1,1,1,1,1,1,1,1,1,1,1,1,2,1,1,1,1,1,1,1,1,1,2,2,1,1,1,1,1,4,4,3,3,3,1,1,1,1,1,1,1,1,1,1,1,1,1,1,3,3,3,3,3,3,3,3,1,1,1,1,1,1,1,1,1,2,1,1,1,1,1,1,1,1,3,3,1,1,1,
3,3,4,3,3,1,1,2,2,1,1,1,1,1,1,1,1,3,2,1,1,1,1,1,1,1,1,1,1,1,1,1,1,2,1,1,1,1,1,1,1,1,2,1,1,4,4,4,4,4,3,3,3,1,1,1,1,1,1,1,2,1,1,1,1,1,1,1,1,1,6,3,3,3,3,3,3,1,1,1,1,1,1,1,1,1,1,1,1,1,1,1,1,1,3,3,3,1,1,1,
3,3,4,3,1,1,7,2,1,1,1,1,1,1,1,1,1,3,2,1,1,1,1,1,1,1,1,1,1,1,1,1,1,2,1,1,1,1,1,1,1,2,1,1,1,4,3,3,3,3,3,1,1,1,1,1,1,1,1,1,2,2,2,1,1,1,1,1,1,1,1,1,1,1,10,3,3,1,1,1,1,1,1,1,1,1,1,1,1,1,1,1,3,3,3,3,1,1,1,1,
3,3,3,3,1,2,2,2,2,1,1,1,1,1,1,1,8,3,2,1,1,1,1,1,1,1,1,1,1,1,1,1,1,2,2,1,1,1,1,1,2,2,1,1,1,1,1,1,1,1,1,1,1,1,1,1,1,1,1,1,1,1,1,1,1,1,1,1,1,1,2,1,1,1,1,3,3,2,2,2,2,1,1,1,1,1,1,2,2,1,3,3,3,3,3,3,1,1,1,1,
1,1,1,3,3,1,1,1,1,1,1,1,1,7,5,5,1,2,2,1,1,1,1,1,1,1,1,1,1,1,1,1,1,1,1,1,1,1,1,1,1,1,1,1,1,1,1,1,1,1,1,1,1,1,1,1,1,1,1,1,1,1,1,1,1,1,1,1,1,1,1,1,1,1,1,3,3,1,1,1,1,1,1,1,1,1,1,1,1,1,1,1,1,1,1,1,1,1,1,1,